ffsfsfd

haha 

hihi

hoho

11111
10001
10101
11111

blabla
